"aN" = (/obj/structure/table,/obj/machinery/light,/turf/open/floor/mineral/titanium,/area/shuttle/ftu_trade)
"bh" = (/obj/effect/turf_decal/bot,/obj/structure/closet/secure_closet{req_access_txt = "208"; name = "Оружие"},/obj/effect/spawner/lootdrop/trader/weapons,/turf/open/floor/mineral/titanium,/area/shuttle/ftu_trade)
"bs" = (/obj/machinery/button/door{id = "ffg"; name = "Cargo Blast Door Toggle"; pixel_y = 28},/turf/open/floor/mineral/titanium,/area/shuttle/ftu_trade)
"bM" = (/obj/structure/sign/poster/contraband/random{pixel_y = -31},/turf/open/floor/iron/smooth_large,/area/shuttle/ftu_trade)
"cy" = (/obj/machinery/porta_turret/centcom_shuttle/ballistic{faction = list("hostile")},/turf/closed/wall/r_wall/syndicate/pirate,/area/shuttle/ftu_trade)
"dC" = (/obj/effect/mob_spawn/human/ftu_crew/sec,/turf/open/floor/iron/smooth_large,/area/shuttle/ftu_trade)
"dM" = (/turf/closed/indestructible/syndicate,/area/shuttle/ftu_trade)
"dQ" = (/turf/open/floor/iron/stairs/right,/area/shuttle/ftu_trade)
"eQ" = (/obj/docking_port/stationary{dwidth = 8; height = 16; id = "ftu_tradeship_home"; name = "Deep space"; width = 30},/obj/structure/fans/tiny,/obj/docking_port/mobile{dheight = 0; dwidth = 8; height = 26; id = "ftu"; launch_status = 0; name = "ftu trade"; port_direction = 8; preferred_direction = 1; width = 15},/obj/machinery/door/airlock/hatch,/obj/machinery/door/poddoor{id = "tew2"; layer = 5},/turf/open/floor/plasteel/shuttle,/area/shuttle/ftu_trade)
"gp" = (/turf/closed/wall/r_wall/syndicate/pirate/nodiagonal,/area/shuttle/ftu_trade)
"gw" = (/obj/structure/shuttle/engine/heater{dir = 8},/obj/structure/window/spawner/west,/turf/open/floor/plating/airless,/area/shuttle/ftu_trade)
"gR" = (/turf/open/floor/carpet/red,/area/shuttle/ftu_trade)
"gW" = (/obj/structure/sign/poster/contraband/random{pixel_y = -31},/turf/open/floor/carpet/red,/area/shuttle/ftu_trade)
"hN" = (/obj/machinery/computer/camera_advanced/shuttle_docker/ftu_tradeship{dir = 8},/turf/open/floor/mineral/titanium,/area/shuttle/ftu_trade)
"jh" = (/obj/structure/fluff/railing/corner{dir = 8},/turf/open/floor/plasteel/yellowsiding{dir = 1},/area/shuttle/ftu_trade)
"ju" = (/obj/structure/table,/obj/item/reagent_containers/food/snacks/chocolatebar{pixel_x = 5; pixel_y = -3},/obj/machinery/light,/obj/item/reagent_containers/food/snacks/soup/facehuggerpot{pixel_y = 17},/turf/open/floor/iron/smooth_large,/area/shuttle/ftu_trade)
"ky" = (/obj/structure/filingcabinet,/obj/machinery/light{dir = 4},/turf/open/floor/carpet/red,/area/shuttle/ftu_trade)
"lm" = (/obj/effect/turf_decal/bot,/obj/structure/closet/secure_closet{req_access_txt = "208"; name = "Шлемы"},/obj/effect/spawner/lootdrop/trader/helmet,/turf/open/floor/mineral/titanium,/area/shuttle/ftu_trade)
"mx" = (/obj/structure/sign/poster/contraband/lusty_xenomorph{pixel_x = -31},/turf/open/floor/mineral/titanium,/area/shuttle/ftu_trade)
"mF" = (/obj/structure/chair/sofa/corp/right{dir = 1},/turf/open/floor/plasteel/yellowsiding{dir = 6},/area/shuttle/ftu_trade)
"mH" = (/obj/structure/shuttle/engine/propulsion{dir = 8},/turf/open/floor/plating/airless,/area/shuttle/ftu_trade)
"nc" = (/obj/machinery/light{dir = 1},/turf/open/floor/mineral/titanium,/area/shuttle/ftu_trade)
"nG" = (/obj/machinery/door/airlock/hatch{req_access_txt = "208"},/turf/open/floor/iron/smooth_large,/area/shuttle/ftu_trade)
"oi" = (/turf/open/floor/wood/wood_large,/area/shuttle/ftu_trade)
"oJ" = (/obj/structure/chair/comfy/shuttle{dir = 4},/turf/open/floor/mineral/titanium,/area/shuttle/ftu_trade)
"pV" = (/obj/machinery/light{dir = 4},/turf/open/floor/pod/light,/area/shuttle/ftu_trade)
"qi" = (/obj/structure/table/wood/fancy/royalblack,/obj/item/paper_bin{pixel_x = -1; pixel_y = 6},/obj/item/pen/fountain,/turf/open/floor/carpet/red,/area/shuttle/ftu_trade)
"ql" = (/obj/effect/mob_spawn/human/ftu_crew,/obj/structure/sign/poster/contraband/gl{pixel_y = 1; pixel_x = -32},/turf/open/floor/pod/light,/area/shuttle/ftu_trade)
"qx" = (/obj/machinery/suit_storage_unit/ftu_work,/turf/open/floor/pod/light,/area/shuttle/ftu_trade)
"qy" = (/obj/structure/window/shuttle/survival_pod/spawner,/obj/structure/grille,/obj/structure/fans/tiny,/obj/machinery/door/poddoor{id = "ssa"; layer = 5},/turf/open/floor/pod/light,/area/shuttle/ftu_trade)
"qF" = (/obj/effect/turf_decal/bot,/obj/structure/closet/secure_closet{req_access_txt = "208"; name = "Не показывать"},/obj/effect/spawner/lootdrop/trader/illigal,/turf/open/floor/mineral/titanium,/area/shuttle/ftu_trade)
"rl" = (/obj/machinery/light/small/built{dir = 8},/obj/structure/table,/obj/machinery/microwave,/turf/open/floor/iron/smooth_large,/area/shuttle/ftu_trade)
"rY" = (/obj/machinery/light,/turf/open/floor/mineral/titanium,/area/shuttle/ftu_trade)
"sq" = (/turf/open/floor/iron/smooth_large,/area/shuttle/ftu_trade)
"su" = (/obj/structure/table,/obj/item/phone{pixel_x = -5; pixel_y = 9},/obj/machinery/button/door{id = "ssa"; name = "Cargo Blast Door Toggle"; req_access_txt = "208"; pixel_x = 6; dir = 1},/obj/machinery/button/door{id = "tew2"; name = "Cargo Blast Door Toggle"; req_access_txt = "208"; pixel_x = 6; pixel_y = 10},/turf/open/floor/mineral/titanium,/area/shuttle/ftu_trade)
"sD" = (/obj/machinery/door/poddoor{id = "ffg"},/turf/open/floor/pod/light,/area/shuttle/ftu_trade)
"sP" = (/obj/structure/filingcabinet,/turf/open/floor/wood/wood_large,/area/shuttle/ftu_trade)
"tW" = (/obj/structure/chair/comfy/black{dir = 1},/turf/open/floor/carpet/red,/area/shuttle/ftu_trade)
"ud" = (/obj/structure/fluff/railing/corner{dir = 4},/turf/open/floor/plasteel/yellowsiding{dir = 8},/area/shuttle/ftu_trade)
"un" = (/obj/structure/chair/sofa/corp{dir = 1},/obj/structure/sign/poster/contraband/random{pixel_y = -31},/turf/open/floor/plasteel/yellowsiding,/area/shuttle/ftu_trade)
"uQ" = (/obj/structure/table,/obj/item/trash/plate{pixel_x = -6; pixel_y = -2},/obj/item/trash/plate{pixel_x = -6},/obj/item/trash/plate{pixel_x = -6; pixel_y = 2},/obj/machinery/light/cold/dim/directional{dir = 1},/turf/open/floor/iron/smooth_large,/area/shuttle/ftu_trade)
"vJ" = (/obj/structure/chair{dir = 8},/turf/open/floor/iron/smooth_large,/area/shuttle/ftu_trade)
"vK" = (/obj/item/reagent_containers/food/condiment/saltshaker{pixel_x = -8; pixel_y = 10},/obj/item/reagent_containers/food/condiment/peppermill{pixel_x = -8; pixel_y = 4},/obj/structure/table,/obj/item/reagent_containers/food/snacks/cakeslice/bscc,/turf/open/floor/iron/smooth_large,/area/shuttle/ftu_trade)
"wr" = (/obj/structure/table/wood/fancy/royalblack,/turf/open/floor/carpet/red,/area/shuttle/ftu_trade)
"xH" = (/obj/structure/table,/turf/open/floor/plasteel/shuttle,/area/shuttle/ftu_trade)
"yi" = (/obj/structure/table,/obj/structure/sign/poster/solgov/recyle{pixel_x = -31},/turf/open/floor/plasteel/yellowsiding{dir = 8},/area/shuttle/ftu_trade)
"ys" = (/obj/machinery/door/airlock/hatch{req_access_txt = "208"},/obj/machinery/door/poddoor/shutters/preopen{id = "gts"},/turf/open/floor/wood/wood_large,/area/shuttle/ftu_trade)
"yt" = (/obj/machinery/button/door{id = "gff"; name = "Cargo Blast Door Toggle"; pixel_y = 28},/turf/open/floor/pod/light,/area/shuttle/ftu_trade)
"yB" = (/turf/template_noop,/area/template_noop)
"zk" = (/obj/effect/turf_decal/bot,/obj/structure/closet/secure_closet{req_access_txt = "208"},/obj/effect/spawner/lootdrop/trader/armor,/turf/open/floor/mineral/titanium,/area/shuttle/ftu_trade)
"zz" = (/obj/machinery/button/door{id = "nee"; name = "Cargo Blast Door Toggle"; pixel_x = -24},/obj/machinery/autolathe/hacked,/turf/open/floor/pod/light,/area/shuttle/ftu_trade)
"zG" = (/obj/effect/mob_spawn/human/ftu_crew/qm,/turf/open/floor/mineral/titanium,/area/shuttle/ftu_trade)
"zS" = (/obj/structure/railing{dir = 1},/turf/open/floor/plasteel/shuttle,/area/shuttle/ftu_trade)
"Ah" = (/obj/structure/chair,/turf/open/floor/mineral/titanium,/area/shuttle/ftu_trade)
"BU" = (/turf/closed/wall/r_wall/syndicate/pirate,/area/shuttle/ftu_trade)
"BV" = (/obj/machinery/computer/shuttle/ftu_tradeship{dir = 8},/turf/open/floor/mineral/titanium,/area/shuttle/ftu_trade)
"Cm" = (/obj/structure/filingcabinet,/turf/open/floor/mineral/titanium,/area/shuttle/ftu_trade)
"Cn" = (/obj/structure/table,/obj/item/paper_bin{pixel_x = -1; pixel_y = 6},/obj/machinery/light{dir = 1},/turf/open/floor/mineral/titanium,/area/shuttle/ftu_trade)
"Dw" = (/obj/machinery/light,/turf/open/floor/plasteel/yellowsiding,/area/shuttle/ftu_trade)
"DR" = (/turf/open/floor/plasteel/shuttle,/area/shuttle/ftu_trade)
"Ei" = (/obj/structure/window/shuttle/survival_pod/spawner,/obj/structure/grille,/obj/machinery/door/poddoor/shutters/preopen{id = "nee"; layer = 5},/turf/open/floor/pod/light,/area/shuttle/ftu_trade)
"Es" = (/obj/structure/chair/comfy/black,/turf/open/floor/carpet/red,/area/shuttle/ftu_trade)
"EO" = (/turf/open/floor/iron/stairs{dir = 4},/area/shuttle/ftu_trade)
"Fh" = (/obj/structure/table,/obj/item/paper_bin{pixel_x = -1; pixel_y = 6},/obj/item/pen/fountain,/turf/open/floor/mineral/titanium,/area/shuttle/ftu_trade)
"FN" = (/obj/effect/turf_decal/bot,/obj/structure/closet/secure_closet{req_access_txt = "208"},/obj/effect/spawner/lootdrop/trader/under,/turf/open/floor/mineral/titanium,/area/shuttle/ftu_trade)
"GD" = (/obj/machinery/suit_storage_unit/ftu_combat,/turf/open/floor/mineral/titanium,/area/shuttle/ftu_trade)
"Hk" = (/turf/open/floor/plasteel/yellowsiding{dir = 1},/area/shuttle/ftu_trade)
"Hr" = (/obj/structure/table,/obj/machinery/coffeemaker,/turf/open/floor/iron/smooth_large,/area/shuttle/ftu_trade)
"HN" = (/obj/item/paper/fluff/traid_ship/old,/turf/open/floor/mineral/titanium,/area/shuttle/ftu_trade)
"HT" = (/obj/structure/chair{dir = 4},/turf/open/floor/iron/smooth_large,/area/shuttle/ftu_trade)
"Ip" = (/obj/machinery/porta_turret/centcom_shuttle/ballistic{faction = list("hostile")},/turf/closed/indestructible/syndicate,/area/shuttle/ftu_trade)
"It" = (/obj/machinery/button/door{id = "tew1"; name = "Cargo Blast Door Toggle"; pixel_x = -30; req_access_txt = "208"},/turf/open/floor/mineral/titanium,/area/shuttle/ftu_trade)
"Jz" = (/obj/structure/railing,/turf/open/floor/plasteel/yellowsiding{dir = 1},/area/shuttle/ftu_trade)
"JT" = (/obj/machinery/smartfridge/food,/obj/item/reagent_containers/food/snacks/breadslice/meat,/obj/item/reagent_containers/food/snacks/breadslice/meat,/obj/item/reagent_containers/food/snacks/breadslice/meat,/obj/item/reagent_containers/food/snacks/burger/bigbite,/obj/item/reagent_containers/food/snacks/burger/bigbite,/obj/item/reagent_containers/food/snacks/burger/cheese,/obj/item/reagent_containers/food/snacks/burger/superbite,/obj/item/reagent_containers/food/snacks/burger/superbite,/obj/item/reagent_containers/food/snacks/cakeslice/chocolate,/obj/item/reagent_containers/food/snacks/cakeslice/chocolate,/obj/item/reagent_containers/food/snacks/cakeslice/chocolate,/obj/item/reagent_containers/food/snacks/meat/steak/wisdomcow,/obj/item/reagent_containers/food/snacks/meat/steak/wisdomcow,/turf/open/floor/iron/smooth_large,/area/shuttle/ftu_trade)
"Kb" = (/obj/machinery/door/airlock/hatch{req_access_txt = "208"},/turf/open/floor/mineral/titanium,/area/shuttle/ftu_trade)
"Kh" = (/turf/open/floor/plasteel/yellowsiding,/area/shuttle/ftu_trade)
"Kn" = (/obj/structure/closet/crate/engineering,/obj/item/stack/sheet/metal/fifty,/obj/item/stack/sheet/metal/fifty,/obj/item/stack/sheet/metal/fifty,/obj/item/stack/sheet/glass/fifty,/obj/item/stack/sheet/glass/fifty,/obj/item/storage/toolbox/syndicate,/obj/structure/sign/poster/contraband/energy_swords{pixel_y = 1; pixel_x = -31},/turf/open/floor/pod/light,/area/shuttle/ftu_trade)
"Kp" = (/turf/open/floor/plasteel/yellowsiding{dir = 4},/area/shuttle/ftu_trade)
"Lm" = (/obj/machinery/light{dir = 4},/turf/open/floor/iron/stairs/right,/area/shuttle/ftu_trade)
"Mi" = (/obj/machinery/vending/coffee,/obj/machinery/light{dir = 1},/turf/open/floor/plasteel/yellowsiding{dir = 5},/area/shuttle/ftu_trade)
"Mk" = (/turf/open/floor/pod/light,/area/shuttle/ftu_trade)
"Mq" = (/obj/machinery/door/poddoor/preopen{id = "tew1"},/obj/machinery/door/airlock/vault{req_access_txt = "208"; id_tag = "tew1"},/turf/open/floor/mineral/titanium,/area/shuttle/ftu_trade)
"MG" = (/obj/machinery/light,/obj/structure/chair/sofa/corp/left{dir = 1},/turf/open/floor/plasteel/yellowsiding,/area/shuttle/ftu_trade)
"MO" = (/obj/machinery/light{dir = 1},/obj/structure/fluff/railing/corner,/turf/open/floor/plasteel/yellowsiding{dir = 9},/area/shuttle/ftu_trade)
"Nh" = (/obj/structure/chair{dir = 1},/turf/open/floor/plasteel/yellowsiding,/area/shuttle/ftu_trade)
"NL" = (/obj/structure/sink{dir = 4; pixel_y = 8; pixel_x = 12},/obj/structure/sign/poster/contraband/random{pixel_x = 30},/turf/open/floor/iron/smooth_large,/area/shuttle/ftu_trade)
"NP" = (/obj/structure/chair,/turf/open/floor/plasteel/shuttle,/area/shuttle/ftu_trade)
"Of" = (/obj/effect/turf_decal/bot,/obj/structure/closet/secure_closet{req_access_txt = "208"; name = "Хардсьюты"},/obj/effect/spawner/lootdrop/trader/hardsuit,/turf/open/floor/mineral/titanium,/area/shuttle/ftu_trade)
"Pn" = (/obj/structure/fluff/railing/corner{dir = 1},/turf/open/floor/plasteel/shuttle,/area/shuttle/ftu_trade)
"Ps" = (/obj/machinery/door/airlock/hatch{id_tag = "tere"},/obj/machinery/door/poddoor/shutters/preopen{id = "tere"},/turf/open/floor/wood/wood_large,/area/shuttle/ftu_trade)
"PT" = (/obj/structure/chair{dir = 1},/turf/open/floor/plasteel/yellowsiding{dir = 10},/area/shuttle/ftu_trade)
"Qh" = (/obj/machinery/light{dir = 1},/turf/open/floor/pod/light,/area/shuttle/ftu_trade)
"QN" = (/obj/structure/table,/turf/open/floor/iron/smooth_large,/area/shuttle/ftu_trade)
"Rc" = (/obj/machinery/door/poddoor/shutters/preopen{id = "nee"; layer = 5},/obj/structure/table/reinforced,/obj/machinery/door/window/survival_pod{req_access_txt = "208"},/turf/open/floor/pod/light,/area/shuttle/ftu_trade)
"Rv" = (/obj/machinery/door/poddoor{id = "gff"},/obj/structure/fans/tiny,/turf/open/floor/pod/light,/area/shuttle/ftu_trade)
"RR" = (/turf/open/floor/mineral/titanium,/area/shuttle/ftu_trade)
"Se" = (/obj/structure/table,/obj/machinery/recharger,/turf/open/floor/mineral/titanium,/area/shuttle/ftu_trade)
"Sn" = (/obj/machinery/button/door{id = "gts"; name = "Cargo Blast Door Toggle"; pixel_y = -30; req_access_txt = "208"},/turf/open/floor/mineral/titanium,/area/shuttle/ftu_trade)
"SX" = (/obj/structure/table,/obj/machinery/fax{pixel_y = 2},/turf/open/floor/mineral/titanium,/area/shuttle/ftu_trade)
"TD" = (/obj/machinery/light{dir = 8},/obj/effect/mob_spawn/human/ftu_crew,/turf/open/floor/pod/light,/area/shuttle/ftu_trade)
"Un" = (/obj/machinery/button/door{id = "tere"; name = "Cargo Blast Door Toggle"; pixel_x = -24; req_access_txt = "208"},/turf/open/floor/wood/wood_large,/area/shuttle/ftu_trade)
"UN" = (/obj/effect/turf_decal/bot,/obj/structure/closet/secure_closet{req_access_txt = "208"; name = "Патроны"},/obj/effect/spawner/lootdrop/trader/ammo,/turf/open/floor/mineral/titanium,/area/shuttle/ftu_trade)
"WJ" = (/obj/structure/tank_dispenser/oxygen,/obj/structure/sign/flag/terragov{pixel_y = 31},/turf/open/floor/mineral/titanium,/area/shuttle/ftu_trade)
"XP" = (/obj/structure/safe{open = 1; name = "Old safe"; desc = "Очень старый сейф. Петли проржавели насквозь и совершенно не хотят дать дверце закрыться, но за то из него выходит отличный шкафчик для гор денег."},/turf/open/floor/mineral/titanium,/area/shuttle/ftu_trade)
"XU" = (/turf/open/floor/iron/stairs/left,/area/shuttle/ftu_trade)
"Yn" = (/obj/structure/chair,/turf/open/floor/plasteel/yellowsiding{dir = 8},/area/shuttle/ftu_trade)
"Zc" = (/obj/ftu_display,/turf/closed/wall/r_wall/syndicate/pirate,/area/shuttle/ftu_trade)
"Zh" = (/obj/effect/turf_decal/bot,/obj/structure/closet/secure_closet{req_access_txt = "208"; name = "Хлам"},/obj/effect/spawner/lootdrop/trader/cool,/turf/open/floor/mineral/titanium,/area/shuttle/ftu_trade)

(1,1,1) = {"
yByBBUcyBUBUBURvRvRvRvBUIpdMdMdMdMdMdMdMdMyByByByByByByB
yBmHgwBUqxQhytMkMkMkMkMksDRRbsRRncRRRRRRdMBUqyqyqyqyBUcy
yBmHgwBUqxMkMkMkMkMkMkMksDRRFNlmzkOfqFRRdMWJGDGDGDsuCnBU
yBmHgwBUqlMkMkMkMkMkMkMksDRRZhbhUNZhbhRRMqRRRRRRRRRRhNqy
yBmHgwBUTDMkMkMkMkMkMkMksDRRrYRRRRRRrYHNdMItRRRRRRoJBVqy
yByBBUBUzzMkMkMkMkMkMkpVdMdMdMdMdMdMdMdMdMmxRRRRRRRRSeqy
yByByBBUKnMkMkMkMkMkMkMkEORRRRRRncRRRRRRKbRRRRAhRRRRCmqy
yByByBBUBUEiRcEiEiEiEiBUgpRRSnRRRRRRRRRRBUzGFhaNSXRRXPBU
yByBBUBUMOJzJzJzjhHkHkMiBUBUBUysBUgpRRRRBUBUBUBUBUBUBUcy
yBmHgwBUudzSzSzSPnDRDRKpBUoioioisPBUXULmBUrluQHrQNJTBUyB
yBmHgwBUYnNPDRDRDRDRDRKpBUUnwrEskyBUXUdQBUsqsqsqsqNLBUyB
yBmHgwBUyixHDRDRDRDRDRKpPsoiwrwrqiBUsqsqnGsqsqHTvKvJBUyB
yBmHgwBUPTNhDwKhKhMGunmFBUoigWtWgRBUdCdCBUsqbMHTjuvJBUyB
yByBBUcyBUZcBUBUeQBUBUBUBUBUBUBUBUBUBUBUcyBUBUBUBUBUBUyB
"}
