"a" = (/turf/closed/wall/r_wall/lf_haron{dir = 8},/area/shuttle/lf_haron)
"b" = (/turf/closed/wall/r_wall/lf_haron/text/second,/area/shuttle/lf_haron)
"c" = (/obj/structure/cable/yellow,/obj/machinery/power/apc/highcap/ten_k{step_x = -25},/obj/structure/closet/gimmick{name = "closet"},/obj/item/claymore/cerberus/bardiche,/obj/item/shield/riot/roman/cerberus,/obj/item/clothing/suit/donator/bm/cerberus_suit/armored,/obj/item/clothing/head/donator/bm/cerberus_helmet/armored,/obj/item/storage/backpack/satchel/leather,/obj/item/clothing/gloves/combat,/obj/item/clothing/shoes/combat,/obj/item/clothing/under/syndicate/combat,/obj/item/clothing/accessory/ring/silver,/obj/item/restraints/legcuffs/bola/tactical,/obj/item/restraints/handcuffs,/obj/item/radio/headset/syndicate/alt,/turf/open/floor/lf_haron/shuttle6,/area/shuttle/lf_haron)
"d" = (/obj/structure/table/survival_pod,/obj/item/clothing/head/donator/bm/pt_crown,/obj/item/clothing/suit/donator/bm/cerberus_suit/armored/baron,/obj/item/claymore/censor,/obj/item/storage/backpack/satchel/leather,/obj/item/clothing/gloves/combat,/obj/item/clothing/shoes/combat,/obj/item/clothing/under/syndicate/combat,/obj/item/clothing/accessory/ring/diamond,/obj/item/radio/headset/syndicate/alt,/turf/open/floor/lf_haron/bar3{dir = 4},/area/shuttle/lf_haron)
"e" = (/obj/machinery/computer/camera_advanced/shuttle_docker/lf_haron{dir = 1},/turf/open/floor/lf_haron/bar2{dir = 1},/area/shuttle/lf_haron)
"f" = (/turf/closed/wall/r_wall/lf_haron/second,/area/shuttle/lf_haron)
"g" = (/turf/closed/wall/r_wall/lf_haron/second{dir = 1},/area/shuttle/lf_haron)
"h" = (/turf/open/floor/lf_haron/bar3{dir = 4},/area/shuttle/lf_haron)
"i" = (/obj/structure/table/reinforced,/obj/machinery/recharger,/turf/open/floor/lf_haron/bar2_red,/area/shuttle/lf_haron)
"j" = (/obj/machinery/door/airlock/external/lf_haron,/obj/structure/fans/tiny/invisible,/obj/docking_port/mobile{name = "Haron"; preferred_direction = 4; id = "lf_haron"; height = 15; width = 8; dir = 2; port_direction = 8},/turf/open/floor/lf_haron/f7{dir = 9},/area/shuttle/lf_haron)
"k" = (/turf/closed/wall/r_wall/lf_haron{dir = 5},/area/shuttle/lf_haron)
"l" = (/obj/machinery/light/small{dir = 4},/obj/structure/closet/gimmick{name = "closet"},/obj/item/reagent_containers/glass/beaker/waterbottle/large,/obj/item/reagent_containers/glass/beaker/waterbottle/large,/obj/item/reagent_containers/glass/beaker/waterbottle/large,/obj/item/reagent_containers/glass/beaker/waterbottle/large,/obj/item/reagent_containers/glass/beaker/waterbottle/large,/obj/item/reagent_containers/food/snacks/meat/steak,/obj/item/reagent_containers/food/snacks/meat/steak,/obj/item/reagent_containers/food/snacks/meat/steak,/obj/item/reagent_containers/food/snacks/meat/steak,/obj/item/reagent_containers/food/snacks/meat/steak,/obj/item/reagent_containers/food/snacks/meat/steak,/obj/item/reagent_containers/food/snacks/meat/steak,/obj/item/reagent_containers/food/snacks/meat/steak,/obj/item/reagent_containers/food/snacks/meat/steak,/obj/item/reagent_containers/food/snacks/meat/steak,/obj/item/reagent_containers/food/snacks/meat/steak,/obj/item/reagent_containers/food/snacks/meat/steak,/obj/item/reagent_containers/food/snacks/meat/steak,/obj/item/reagent_containers/food/snacks/meat/steak,/obj/item/reagent_containers/food/snacks/meat/steak,/obj/item/storage/firstaid/regular,/obj/item/storage/firstaid/regular,/obj/item/storage/firstaid/regular,/obj/item/storage/firstaid/regular,/obj/item/storage/firstaid/regular,/obj/item/storage/backpack/duffelbag/sec/surgery,/turf/open/floor/lf_haron/bar2{dir = 4},/area/shuttle/lf_haron)
"m" = (/turf/closed/wall/r_wall/lf_haron/second{dir = 8},/area/shuttle/lf_haron)
"n" = (/obj/structure/table/reinforced,/obj/item/storage/box/handcuffs,/turf/open/floor/lf_haron/bar2_red,/area/shuttle/lf_haron)
"o" = (/obj/machinery/light/small{dir = 4},/obj/structure/closet/gimmick{name = "closet"},/obj/item/shield/riot/roman/cerberus,/obj/item/clothing/suit/donator/bm/cerberus_suit/armored,/obj/item/clothing/head/donator/bm/cerberus_helmet/armored,/obj/item/spear/cerberus,/obj/item/storage/backpack/satchel/leather,/obj/item/clothing/gloves/combat,/obj/item/clothing/shoes/combat,/obj/item/clothing/under/syndicate/combat,/obj/item/clothing/accessory/ring/silver,/obj/item/restraints/legcuffs/bola/tactical,/obj/item/restraints/handcuffs,/obj/item/radio/headset/syndicate/alt,/turf/open/floor/lf_haron/f7{dir = 9},/area/shuttle/lf_haron)
"p" = (/obj/machinery/light/small{dir = 1},/turf/open/floor/lf_haron/polar,/area/shuttle/lf_haron)
"q" = (/turf/closed/wall/r_wall/lf_haron/diagonal{dir = 6},/area/shuttle/lf_haron)
"r" = (/obj/machinery/power/terminal{dir = 8},/turf/open/floor/lf_haron/f7{dir = 9},/area/shuttle/lf_haron)
"s" = (/obj/structure/shuttle/engine/heater{dir = 1},/obj/structure/window/reinforced,/turf/open/floor/lf_haron/shuttle6,/area/shuttle/lf_haron)
"t" = (/obj/structure/chair/comfy/shuttle{dir = 8},/turf/open/floor/lf_haron/f7{dir = 9},/area/shuttle/lf_haron)
"u" = (/obj/machinery/door/airlock/external/lf_haron,/turf/open/floor/lf_haron/bar3{dir = 1},/area/shuttle/lf_haron)
"v" = (/obj/structure/shuttle/engine/propulsion/burst/left{dir = 1},/turf/open/floor/plating,/area/shuttle/lf_haron)
"w" = (/obj/machinery/computer{dir = 1},/turf/open/floor/lf_haron/bar2{dir = 1},/area/shuttle/lf_haron)
"x" = (/obj/structure/closet/gimmick{name = "closet"},/obj/item/claymore/cerberus,/obj/item/shield/riot/roman/cerberus,/obj/item/clothing/suit/donator/bm/cerberus_suit/armored,/obj/item/clothing/head/donator/bm/cerberus_helmet/armored,/obj/item/storage/backpack/satchel/leather,/obj/item/clothing/gloves/combat,/obj/item/clothing/shoes/combat,/obj/item/clothing/under/syndicate/combat,/obj/item/clothing/accessory/ring/silver,/obj/item/restraints/legcuffs/bola/tactical,/obj/item/restraints/handcuffs,/obj/item/radio/headset/syndicate/alt,/turf/open/floor/lf_haron/shuttle6,/area/shuttle/lf_haron)
"y" = (/obj/structure/window/reinforced/fulltile/lf_haron,/turf/open/floor/lf_haron/bar2_red{dir = 4},/area/shuttle/lf_haron)
"z" = (/turf/closed/wall/r_wall/lf_haron{dir = 6},/area/shuttle/lf_haron)
"A" = (/obj/machinery/nuclearbomb/beer{anchored = 1; desc = "Король разрешил семье Барона оставить эту бомбу в знак уважения, но коды активации уже давно куда-то потерялись."; name = "\improper Гнев-Господа"},/turf/open/floor/lf_haron/f7{dir = 9},/area/shuttle/lf_haron)
"B" = (/turf/open/floor/lf_haron/f7{dir = 9},/area/shuttle/lf_haron)
"C" = (/obj/machinery/computer/shuttle/lf_haron{dir = 1},/turf/open/floor/lf_haron/bar3{dir = 1},/area/shuttle/lf_haron)
"D" = (/obj/structure/chair/comfy/shuttle,/turf/open/floor/lf_haron/polar,/area/shuttle/lf_haron)
"E" = (/obj/machinery/light/small,/turf/open/floor/lf_haron/shuttle3,/area/shuttle/lf_haron)
"F" = (/turf/closed/wall/r_wall/lf_haron/diagonal{dir = 9},/area/shuttle/lf_haron)
"G" = (/turf/closed/wall/r_wall/lf_haron/second{dir = 6},/area/shuttle/lf_haron)
"H" = (/obj/structure/cable/yellow{icon_state = "0-2"},/obj/machinery/power/smes/magical,/turf/open/floor/lf_haron/f7{dir = 9},/area/shuttle/lf_haron)
"I" = (/turf/open/floor/lf_haron/polar,/area/shuttle/lf_haron)
"J" = (/obj/structure/window/reinforced/fulltile/lf_haron,/turf/open/floor/lf_haron/bar2_red{dir = 8},/area/shuttle/lf_haron)
"K" = (/turf/closed/wall/r_wall/lf_haron/second{dir = 9},/area/shuttle/lf_haron)
"L" = (/turf/open/floor/lf_haron/shuttle3,/area/shuttle/lf_haron)
"M" = (/turf/open/space/basic,/area/template_noop)
"N" = (/turf/closed/wall/r_wall/lf_haron/second{dir = 5},/area/shuttle/lf_haron)
"O" = (/obj/machinery/light/small{dir = 8},/obj/structure/closet/gimmick{name = "closet"},/obj/item/claymore/censor,/obj/item/clothing/suit/donator/bm/cerberus_suit/armored/censor,/obj/item/shield/riot/roman/cerberus,/obj/item/storage/backpack/satchel/leather,/obj/item/clothing/gloves/combat,/obj/item/clothing/shoes/combat,/obj/item/clothing/under/syndicate/combat,/obj/item/clothing/accessory/ring,/obj/item/restraints/legcuffs/bola/tactical,/obj/item/restraints/handcuffs,/obj/item/radio/headset/syndicate/alt,/turf/open/floor/lf_haron/f7{dir = 9},/area/shuttle/lf_haron)
"P" = (/turf/closed/wall/r_wall/lf_haron/diagonal{dir = 5},/area/shuttle/lf_haron)
"Q" = (/turf/closed/wall/r_wall/lf_haron/diagonal{dir = 8},/area/shuttle/lf_haron)
"R" = (/turf/closed/wall/r_wall/lf_haron/text/first,/area/shuttle/lf_haron)
"S" = (/turf/closed/wall/r_wall/lf_haron{dir = 10},/area/shuttle/lf_haron)
"T" = (/obj/machinery/door/airlock/external/lf_haron,/turf/open/floor/lf_haron/f7{dir = 9},/area/shuttle/lf_haron)
"U" = (/obj/structure/chair/comfy/shuttle{dir = 4},/turf/open/floor/lf_haron/f7{dir = 9},/area/shuttle/lf_haron)
"V" = (/turf/open/floor/lf_haron/f7{dir = 5},/area/shuttle/lf_haron)
"W" = (/turf/open/floor/lf_haron/shuttle6,/area/shuttle/lf_haron)
"X" = (/obj/structure/closet/gimmick{name = "closet"},/obj/item/claymore/cerberus,/obj/item/shield/riot/roman/cerberus,/obj/item/clothing/suit/donator/bm/cerberus_suit/armored,/obj/item/clothing/head/donator/bm/cerberus_helmet/armored,/obj/item/storage/backpack/satchel/leather,/obj/item/clothing/gloves/combat,/obj/item/clothing/shoes/combat,/obj/item/clothing/under/syndicate/combat,/obj/item/clothing/accessory/ring/silver,/obj/item/restraints/legcuffs/bola/tactical,/obj/item/restraints/handcuffs,/obj/item/radio/headset/syndicate/alt,/turf/open/floor/lf_haron/f7{dir = 9},/area/shuttle/lf_haron)
"Y" = (/obj/structure/window/reinforced/fulltile/lf_haron,/turf/open/floor/lf_haron/bar2_red{dir = 1},/area/shuttle/lf_haron)
"Z" = (/turf/closed/wall/r_wall/lf_haron/text/third,/area/shuttle/lf_haron)

(1,1,1) = {"
MQvajavq
MfsgVmsa
MaHrBBXa
MacWWWxa
MaOBBBoa
zKGNTzfa
kULLBTLz
yULLtalk
zULLtzga
kfLEAkdz
PauRbZhS
MahIpIhk
MYnIDIiJ
MPawCeaF
MMPayaFM
"}
