//MAP CONVERTED BY dmm2tgm.py THIS HEADER COMMENT PREVENTS RECONVERSION, DO NOT REMOVE
"ao" = (
/obj/machinery/light{
	dir = 8;
	light_color = "#e8eaff"
	},
/obj/machinery/atmospherics/pipe/simple/supply/hidden,
/turf/open/floor/carpet/red,
/area/hilbertshotel{
	dynamic_lighting = 1
	})
"aw" = (
/obj/structure/closet/cabinet,
/obj/machinery/atmospherics/pipe/simple/scrubbers/hidden/layer3{
	dir = 9
	},
/turf/open/floor/wood/wood_large,
/area/hilbertshotel{
	dynamic_lighting = 1
	})
"aC" = (
/turf/closed/indestructible/sandstone,
/area/hilbertshotel{
	dynamic_lighting = 1
	})
"bm" = (
/obj/machinery/atmospherics/components/unary/vent_scrubber/hilbertshotel/layer3,
/turf/open/floor/holofloor/wood,
/area/hilbertshotel{
	dynamic_lighting = 1
	})
"dh" = (
/obj/machinery/atmospherics/pipe/simple/scrubbers/hidden/layer3,
/obj/machinery/atmospherics/pipe/simple/supply/hidden{
	dir = 10
	},
/turf/open/floor/holofloor/wood,
/area/hilbertshotel{
	dynamic_lighting = 1
	})
"di" = (
/obj/structure/chair/wood{
	dir = 1
	},
/turf/open/floor/holofloor/wood,
/area/hilbertshotel{
	dynamic_lighting = 1
	})
"dm" = (
/turf/open/floor/spooktime/beach/coasts/coastNE,
/area/hilbertshotel{
	dynamic_lighting = 1
	})
"dC" = (
/obj/effect/spawner/structure/window/reinforced,
/turf/open/floor/plating,
/area/hilbertshotel{
	dynamic_lighting = 1
	})
"dJ" = (
/obj/structure/table,
/obj/machinery/microwave{
	pixel_y = 6
	},
/turf/open/floor/iron/white,
/area/hilbertshotel{
	dynamic_lighting = 1
	})
"eC" = (
/obj/structure/chair/sofa/corp{
	dir = 1
	},
/obj/machinery/light{
	light_color = "#cee5d2"
	},
/obj/machinery/atmospherics/pipe/simple/scrubbers/hidden/layer3{
	dir = 4
	},
/obj/machinery/atmospherics/pipe/simple/supply/hidden{
	dir = 4
	},
/turf/open/floor/carpet/royalblue,
/area/hilbertshotel{
	dynamic_lighting = 1
	})
"eY" = (
/obj/structure/closet/cabinet,
/turf/open/floor/wood/wood_large,
/area/hilbertshotel{
	dynamic_lighting = 1
	})
"fz" = (
/turf/closed/indestructible/wood,
/area/hilbertshotel{
	dynamic_lighting = 1
	})
"gx" = (
/obj/structure/table,
/obj/item/pizzabox/meat{
	pixel_y = 7
	},
/turf/open/floor/carpet/royalblue,
/area/hilbertshotel{
	dynamic_lighting = 1
	})
"gG" = (
/obj/machinery/atmospherics/components/unary/vent_pump/on{
	dir = 4
	},
/turf/open/floor/holofloor/wood,
/area/hilbertshotel{
	dynamic_lighting = 1
	})
"gH" = (
/obj/machinery/atmospherics/pipe/simple/supply/hidden{
	dir = 5
	},
/turf/open/floor/carpet/red,
/area/hilbertshotel{
	dynamic_lighting = 1
	})
"hw" = (
/obj/effect/turf_decal/siding/wood{
	dir = 8
	},
/obj/effect/turf_decal/siding/wood{
	dir = 4
	},
/obj/machinery/door/morgue,
/obj/machinery/atmospherics/pipe/simple/scrubbers/hidden/layer3{
	dir = 4
	},
/obj/machinery/atmospherics/pipe/simple/supply/hidden{
	dir = 4
	},
/turf/open/floor/holofloor/wood,
/area/hilbertshotel{
	dynamic_lighting = 1
	})
"hD" = (
/obj/machinery/door/window/southleft,
/turf/open/floor/iron/white/smooth_large,
/area/hilbertshotel{
	dynamic_lighting = 1
	})
"hH" = (
/obj/item/toy/beach_ball,
/turf/open/floor/spooktime/beach/water,
/area/hilbertshotel{
	dynamic_lighting = 1
	})
"hQ" = (
/obj/structure/lattice,
/obj/machinery/atmospherics/components/unary/outlet_injector/hilbertshotel/layer3{
	dir = 1
	},
/turf/open/space/bluespace,
/area/hilbertshotel{
	dynamic_lighting = 1
	})
"ig" = (
/obj/machinery/vending/boozeomat{
	onstation = 0;
	shut_up = 1
	},
/turf/open/floor/holofloor/wood,
/area/hilbertshotel{
	dynamic_lighting = 1
	})
"jg" = (
/obj/machinery/atmospherics/pipe/simple/scrubbers/hidden/layer3,
/obj/machinery/atmospherics/pipe/simple/supply/hidden,
/turf/closed/indestructible/wood,
/area/hilbertshotel{
	dynamic_lighting = 1
	})
"jN" = (
/obj/machinery/light{
	dir = 1
	},
/obj/effect/turf_decal/siding/wood{
	dir = 8
	},
/turf/open/floor/iron/white,
/area/hilbertshotel{
	dynamic_lighting = 1
	})
"jR" = (
/obj/machinery/telecomms/relay/preset/auto,
/turf/open/floor/catwalk_floor,
/area/hilbertshotel{
	dynamic_lighting = 1
	})
"ko" = (
/turf/open/floor/plating/beach/sand,
/area/hilbertshotel{
	dynamic_lighting = 1
	})
"lF" = (
/turf/open/floor/spooktime/beach/coasts/watercoastN{
	barefootstep = "water";
	clawfootstep = "water";
	footstep = "water";
	heavyfootstep = "water"
	},
/area/hilbertshotel{
	dynamic_lighting = 1
	})
"lG" = (
/obj/machinery/light{
	light_color = "#cee5d2"
	},
/turf/open/floor/holofloor/wood,
/area/hilbertshotel{
	dynamic_lighting = 1
	})
"lJ" = (
/obj/machinery/light_switch/directional/south,
/turf/open/floor/wood/wood_large,
/area/hilbertshotel{
	dynamic_lighting = 1
	})
"mA" = (
/obj/structure/lattice,
/obj/machinery/atmospherics/components/unary/tank/air{
	dir = 8
	},
/turf/open/space/bluespace,
/area/hilbertshotel{
	dynamic_lighting = 1
	})
"nF" = (
/obj/effect/turf_decal/siding/wood,
/obj/effect/turf_decal/siding/wood{
	dir = 1
	},
/obj/machinery/door/morgue,
/turf/open/floor/holofloor/wood,
/area/hilbertshotel{
	dynamic_lighting = 1
	})
"nW" = (
/obj/effect/turf_decal/siding/wood{
	dir = 1
	},
/obj/machinery/atmospherics/pipe/simple/scrubbers/hidden/layer3,
/obj/item/kirbyplants/random,
/turf/open/floor/wood/wood_large,
/area/hilbertshotel{
	dynamic_lighting = 1
	})
"oD" = (
/obj/machinery/light{
	dir = 1
	},
/obj/structure/sign/painting/library{
	pixel_x = -1;
	pixel_y = -26
	},
/turf/open/floor/wood/wood_large,
/area/hilbertshotel{
	dynamic_lighting = 1
	})
"oG" = (
/turf/open/floor/spooktime/beach/coasts/coastN,
/area/hilbertshotel{
	dynamic_lighting = 1
	})
"pq" = (
/obj/machinery/atmospherics/pipe/simple/scrubbers/hidden/layer3{
	dir = 5
	},
/obj/machinery/atmospherics/pipe/manifold/supply/hidden,
/obj/item/kirbyplants/random,
/turf/open/floor/wood/wood_large,
/area/hilbertshotel{
	dynamic_lighting = 1
	})
"pN" = (
/turf/open/floor/spooktime/beach/coasts/innerE,
/area/hilbertshotel{
	dynamic_lighting = 1
	})
"rN" = (
/obj/machinery/light{
	dir = 1;
	light_color = "#cee5d2"
	},
/obj/machinery/atmospherics/pipe/manifold/scrubbers/hidden/layer3,
/obj/machinery/atmospherics/pipe/manifold/supply/hidden,
/turf/open/floor/wood/wood_large,
/area/hilbertshotel{
	dynamic_lighting = 1
	})
"sm" = (
/obj/machinery/atmospherics/pipe/simple/scrubbers/hidden/layer3{
	dir = 4
	},
/obj/machinery/atmospherics/pipe/simple/supply/hidden{
	dir = 4
	},
/obj/structure/sign/painting/library{
	pixel_y = 29
	},
/turf/open/floor/wood/wood_large,
/area/hilbertshotel{
	dynamic_lighting = 1
	})
"tn" = (
/obj/machinery/atmospherics/pipe/simple/scrubbers/hidden/layer3{
	dir = 6
	},
/obj/machinery/atmospherics/pipe/simple/supply/hidden{
	dir = 6
	},
/obj/item/kirbyplants/random,
/turf/open/floor/wood/wood_large,
/area/hilbertshotel{
	dynamic_lighting = 1
	})
"ts" = (
/obj/structure/fluff/beach_umbrella,
/turf/open/floor/spooktime/beach/coasts/coastN,
/area/hilbertshotel{
	dynamic_lighting = 1
	})
"tF" = (
/turf/open/floor/spooktime/beach/coasts/innerN,
/area/hilbertshotel{
	dynamic_lighting = 1
	})
"uj" = (
/obj/structure/table,
/obj/effect/spawner/lootdrop/three_course_meal,
/obj/machinery/reagentgrinder{
	pixel_y = 8
	},
/obj/item/sharpener{
	pixel_x = -10;
	pixel_y = -8
	},
/turf/open/floor/iron/white,
/area/hilbertshotel{
	dynamic_lighting = 1
	})
"us" = (
/turf/open/floor/spooktime/beach/coasts/watercoastN,
/area/hilbertshotel{
	dynamic_lighting = 1
	})
"uw" = (
/obj/machinery/atmospherics/pipe/simple/supply/hidden{
	dir = 4
	},
/obj/machinery/atmospherics/pipe/simple/scrubbers/hidden/layer3{
	dir = 4
	},
/obj/machinery/vending/kink{
	onstation = 0;
	shut_up = 1
	},
/turf/open/floor/wood/wood_large,
/area/hilbertshotel{
	dynamic_lighting = 1
	})
"uD" = (
/obj/structure/table,
/turf/open/floor/carpet/royalblue,
/area/hilbertshotel{
	dynamic_lighting = 1
	})
"vq" = (
/obj/structure/chair/sofa/corp/left{
	dir = 1
	},
/obj/machinery/atmospherics/pipe/simple/scrubbers/hidden/layer3{
	dir = 4
	},
/obj/machinery/atmospherics/pipe/simple/supply/hidden{
	dir = 4
	},
/turf/open/floor/carpet/royalblue,
/area/hilbertshotel{
	dynamic_lighting = 1
	})
"vW" = (
/obj/structure/toilet{
	dir = 4
	},
/turf/open/floor/iron/white/smooth_large,
/area/hilbertshotel{
	dynamic_lighting = 1
	})
"wF" = (
/obj/machinery/light{
	light_color = "#c9d3e8"
	},
/obj/machinery/atmospherics/pipe/simple/scrubbers/hidden/layer3{
	dir = 4
	},
/turf/open/floor/wood/wood_large,
/area/hilbertshotel{
	dynamic_lighting = 1
	})
"yE" = (
/obj/structure/table,
/obj/item/reagent_containers/food/drinks/beer,
/obj/item/reagent_containers/food/drinks/beer{
	pixel_x = -9
	},
/obj/item/reagent_containers/food/drinks/beer{
	pixel_x = 8;
	pixel_y = 8
	},
/turf/open/floor/carpet/royalblue,
/area/hilbertshotel{
	dynamic_lighting = 1
	})
"yR" = (
/turf/open/floor/carpet/red,
/area/hilbertshotel{
	dynamic_lighting = 1
	})
"zT" = (
/obj/structure/chair/sofa/middle{
	dir = 1
	},
/turf/open/floor/plating/beach/sand,
/area/hilbertshotel{
	dynamic_lighting = 1
	})
"zX" = (
/obj/effect/turf_decal/siding/wood{
	dir = 4
	},
/obj/effect/turf_decal/siding/wood{
	dir = 8
	},
/obj/machinery/door/morgue,
/turf/open/floor/holofloor/wood,
/area/hilbertshotel{
	dynamic_lighting = 1
	})
"Ae" = (
/obj/structure/chair/sofa/corp{
	dir = 1
	},
/obj/machinery/atmospherics/pipe/simple/scrubbers/hidden/layer3{
	dir = 4
	},
/obj/machinery/atmospherics/pipe/simple/supply/hidden{
	dir = 4
	},
/turf/open/floor/carpet/royalblue,
/area/hilbertshotel{
	dynamic_lighting = 1
	})
"As" = (
/obj/structure/lattice,
/obj/machinery/atmospherics/pipe/simple/supply/hidden{
	dir = 4
	},
/turf/closed/indestructible/sandstone,
/area/hilbertshotel{
	dynamic_lighting = 1
	})
"Bl" = (
/obj/structure/chair/wood{
	dir = 8
	},
/obj/structure/curtain{
	pixel_y = 32
	},
/turf/open/floor/holofloor/wood,
/area/hilbertshotel{
	dynamic_lighting = 1
	})
"BW" = (
/obj/structure/curtain{
	pixel_y = 32
	},
/obj/structure/table/wood,
/obj/item/reagent_containers/food/condiment/peppermill{
	pixel_x = 6
	},
/obj/item/reagent_containers/food/condiment/saltshaker,
/obj/effect/spawner/lootdrop/three_course_meal,
/turf/open/floor/holofloor/wood,
/area/hilbertshotel{
	dynamic_lighting = 1
	})
"Cb" = (
/obj/machinery/vending/dinnerware{
	contraband = list(/obj/item/kitchen/rollingpin=2,/obj/item/kitchen/knife/butcher=2,/obj/item/reagent_containers/food/condiment/flour=4);
	shut_up = 1
	},
/turf/open/floor/iron/white,
/area/hilbertshotel{
	dynamic_lighting = 1
	})
"Ch" = (
/obj/structure/chair/sofa/corp/left{
	dir = 8
	},
/turf/open/floor/carpet/royalblue,
/area/hilbertshotel{
	dynamic_lighting = 1
	})
"Co" = (
/obj/machinery/atmospherics/components/unary/vent_pump/on{
	external_pressure_bound = 140;
	name = "killroom vent";
	pressure_checks = 0
	},
/turf/open/floor/wood/wood_large,
/area/hilbertshotel{
	dynamic_lighting = 1
	})
"CM" = (
/obj/structure/chair/sofa/corp/corner{
	dir = 8
	},
/obj/machinery/atmospherics/pipe/simple/scrubbers/hidden/layer3{
	dir = 4
	},
/obj/machinery/atmospherics/pipe/simple/supply/hidden{
	dir = 4
	},
/turf/open/floor/carpet/royalblue,
/area/hilbertshotel{
	dynamic_lighting = 1
	})
"CY" = (
/obj/effect/turf_decal/siding/wood{
	dir = 1
	},
/turf/open/floor/wood/wood_large,
/area/hilbertshotel{
	dynamic_lighting = 1
	})
"Dn" = (
/obj/structure/curtain{
	pixel_y = 32
	},
/obj/structure/table/wood,
/obj/item/flashlight/lamp/green{
	pixel_y = 2
	},
/obj/machinery/atmospherics/components/unary/vent_scrubber/hilbertshotel/layer3,
/turf/open/floor/carpet/red,
/area/hilbertshotel{
	dynamic_lighting = 1
	})
"EB" = (
/obj/structure/lattice,
/turf/closed/indestructible/sandstone,
/area/hilbertshotel{
	dynamic_lighting = 1
	})
"Ft" = (
/obj/machinery/jukebox{
	req_one_access = null;
	one_area_play = 1
	},
/turf/open/floor/wood/wood_large,
/area/hilbertshotel{
	dynamic_lighting = 1
	})
"FG" = (
/turf/open/floor/iron/white/smooth_large,
/area/hilbertshotel{
	dynamic_lighting = 1
	})
"FL" = (
/obj/machinery/door/morgue,
/turf/open/floor/holofloor/wood,
/area/hilbertshotel{
	dynamic_lighting = 1
	})
"GF" = (
/obj/structure/lattice,
/obj/machinery/atmospherics/pipe/manifold/supply/hidden{
	dir = 4
	},
/obj/machinery/meter,
/turf/open/space/bluespace,
/area/hilbertshotel{
	dynamic_lighting = 1
	})
"GR" = (
/obj/machinery/door/morgue,
/turf/open/floor/wood/wood_large,
/area/hilbertshotel{
	dynamic_lighting = 1
	})
"GT" = (
/obj/structure/mineral_door/wood,
/turf/open/floor/holofloor/wood,
/area/hilbertshotel{
	dynamic_lighting = 1
	})
"Ir" = (
/obj/structure/curtain{
	pixel_y = 32
	},
/obj/structure/dresser,
/obj/machinery/atmospherics/components/unary/vent_pump/on,
/turf/open/floor/carpet/red,
/area/hilbertshotel{
	dynamic_lighting = 1
	})
"KX" = (
/obj/structure/chair/sofa/left{
	dir = 1
	},
/turf/open/floor/plating/beach/sand,
/area/hilbertshotel{
	dynamic_lighting = 1
	})
"Ll" = (
/obj/structure/curtain{
	pixel_y = 32
	},
/obj/structure/chair/wood{
	dir = 4
	},
/turf/open/floor/holofloor/wood,
/area/hilbertshotel{
	dynamic_lighting = 1
	})
"Mw" = (
/obj/structure/curtain{
	pixel_y = 32
	},
/obj/structure/bed/double,
/obj/item/bedsheet/black/double,
/turf/open/floor/carpet/red,
/area/hilbertshotel{
	dynamic_lighting = 1
	})
"MO" = (
/obj/machinery/atmospherics/pipe/simple/scrubbers/hidden/layer3,
/obj/machinery/atmospherics/pipe/simple/supply/hidden,
/turf/open/floor/wood/wood_large,
/area/hilbertshotel{
	dynamic_lighting = 1
	})
"Ne" = (
/obj/structure/chair/sofa/right{
	dir = 1
	},
/turf/open/floor/plating/beach/sand,
/area/hilbertshotel{
	dynamic_lighting = 1
	})
"Nq" = (
/obj/effect/turf_decal/siding/wood{
	dir = 8
	},
/turf/open/floor/iron/white,
/area/hilbertshotel{
	dynamic_lighting = 1
	})
"NP" = (
/obj/structure/lattice,
/turf/closed/indestructible/wood,
/area/hilbertshotel{
	dynamic_lighting = 1
	})
"Oa" = (
/turf/open/floor/spooktime/beach/water,
/area/hilbertshotel{
	dynamic_lighting = 1
	})
"Ou" = (
/obj/machinery/atmospherics/pipe/manifold/scrubbers/hidden/layer3,
/obj/machinery/atmospherics/pipe/simple/supply/hidden{
	dir = 4
	},
/obj/structure/sign/painting/library{
	pixel_x = 1;
	pixel_y = -26
	},
/turf/open/floor/wood/wood_large,
/area/hilbertshotel{
	dynamic_lighting = 1
	})
"Qw" = (
/obj/machinery/atmospherics/pipe/simple/supply/hidden{
	dir = 4
	},
/obj/machinery/atmospherics/pipe/simple/scrubbers/hidden/layer3{
	dir = 10
	},
/turf/closed/indestructible/wood,
/area/hilbertshotel{
	dynamic_lighting = 1
	})
"Rb" = (
/turf/open/floor/holofloor/wood,
/area/hilbertshotel{
	dynamic_lighting = 1
	})
"SV" = (
/obj/machinery/shower{
	desc = "Despite their age, they seem clean and capable of providing hot water just as well as their modern counterparts. Hopefully Nanotrasen cleaned the water pipes this well...";
	pixel_y = -1;
	dir = 4
	},
/obj/effect/turf_decal/siding/thinplating/end{
	dir = 4
	},
/obj/structure/window/reinforced/tinted,
/turf/open/floor/iron/white/smooth_large,
/area/hilbertshotel{
	dynamic_lighting = 1
	})
"Tg" = (
/obj/machinery/atmospherics/components/unary/vent_scrubber/hilbertshotel/layer3,
/turf/open/floor/wood/wood_large,
/area/hilbertshotel{
	dynamic_lighting = 1
	})
"TF" = (
/obj/machinery/atmospherics/pipe/simple/scrubbers/hidden/layer3,
/obj/structure/sign/painting/library{
	pixel_x = 29
	},
/turf/open/floor/carpet/red,
/area/hilbertshotel{
	dynamic_lighting = 1
	})
"Wd" = (
/obj/effect/turf_decal/siding/wood{
	dir = 1
	},
/obj/machinery/atmospherics/pipe/simple/supply/hidden,
/turf/open/floor/wood/wood_large,
/area/hilbertshotel{
	dynamic_lighting = 1
	})
"Wx" = (
/turf/open/floor/spooktime/beach/coasts/coastNW,
/area/hilbertshotel{
	dynamic_lighting = 1
	})
"WC" = (
/obj/structure/table,
/obj/structure/bedsheetbin/towel,
/obj/machinery/light{
	dir = 8;
	light_color = "#e8eaff"
	},
/turf/open/floor/iron/white/smooth_large,
/area/hilbertshotel{
	dynamic_lighting = 1
	})
"Xg" = (
/obj/machinery/atmospherics/pipe/simple/scrubbers/hidden/layer3{
	dir = 4
	},
/obj/machinery/atmospherics/pipe/simple/supply/hidden{
	dir = 4
	},
/turf/closed/indestructible/wood,
/area/hilbertshotel{
	dynamic_lighting = 1
	})
"Xw" = (
/obj/machinery/atmospherics/pipe/simple/scrubbers/hidden/layer3{
	dir = 4
	},
/obj/machinery/atmospherics/pipe/simple/supply/hidden{
	dir = 9
	},
/turf/open/floor/wood/wood_large,
/area/hilbertshotel{
	dynamic_lighting = 1
	})
"Yb" = (
/obj/machinery/light{
	dir = 1;
	light_color = "#cee5d2"
	},
/obj/machinery/atmospherics/pipe/simple/scrubbers/hidden/layer3{
	dir = 4
	},
/obj/machinery/atmospherics/pipe/simple/supply/hidden{
	dir = 4
	},
/turf/open/floor/wood/wood_large,
/area/hilbertshotel{
	dynamic_lighting = 1
	})
"YA" = (
/turf/closed/indestructible/hoteldoor{
	icon_state = "door_closed";
	icon = 'icons/obj/doors/puzzledoor/default.dmi'
	},
/area/hilbertshotel{
	dynamic_lighting = 1
	})
"YO" = (
/obj/machinery/atmospherics/pipe/simple/scrubbers/hidden/layer3{
	dir = 4
	},
/obj/machinery/atmospherics/pipe/simple/supply/hidden{
	dir = 4
	},
/turf/open/floor/wood/wood_large,
/area/hilbertshotel{
	dynamic_lighting = 1
	})

(1,1,1) = {"
EB
EB
EB
aC
aC
aC
aC
aC
aC
fz
fz
fz
fz
NP
NP
NP
"}
(2,1,1) = {"
EB
lF
Oa
Oa
Oa
Oa
dm
tF
ko
fz
eY
fz
SV
WC
vW
NP
"}
(3,1,1) = {"
EB
lF
Oa
Oa
Oa
Oa
us
oG
ko
fz
oD
fz
hD
FG
FG
NP
"}
(4,1,1) = {"
aC
Oa
Oa
us
Oa
Oa
us
oG
ko
GT
lJ
fz
fz
FL
fz
fz
"}
(5,1,1) = {"
aC
Oa
Oa
us
Oa
Oa
Wx
pN
fz
fz
zX
fz
Ft
Co
gH
YA
"}
(6,1,1) = {"
aC
Oa
Oa
us
Oa
Oa
oG
fz
fz
ig
gG
fz
tn
MO
pq
fz
"}
(7,1,1) = {"
aC
Oa
Oa
Oa
us
Wx
pN
dC
Ll
bm
dh
jg
rN
Tg
Ou
fz
"}
(8,1,1) = {"
aC
Oa
us
Oa
us
ts
ko
dC
BW
di
lG
fz
sm
uD
vq
fz
"}
(9,1,1) = {"
aC
Oa
us
Oa
us
oG
ko
dC
Bl
Rb
Rb
nF
YO
gx
eC
fz
"}
(10,1,1) = {"
aC
Oa
Oa
Oa
hH
dm
tF
fz
jN
Nq
Nq
fz
YO
yE
Ae
fz
"}
(11,1,1) = {"
aC
Oa
Oa
us
Oa
Oa
oG
fz
uj
dJ
Cb
fz
Yb
Ch
CM
fz
"}
(12,1,1) = {"
aC
Oa
Oa
us
Oa
us
oG
fz
fz
fz
fz
fz
hw
fz
Xg
fz
"}
(13,1,1) = {"
aC
lF
Oa
us
Oa
us
oG
KX
dC
Ir
ao
Wd
Xw
GR
uw
fz
"}
(14,1,1) = {"
EB
lF
Oa
Oa
Oa
us
oG
zT
dC
Mw
yR
CY
wF
fz
Qw
hQ
"}
(15,1,1) = {"
EB
lF
Oa
Oa
Oa
Oa
oG
Ne
dC
Dn
TF
nW
aw
fz
As
jR
"}
(16,1,1) = {"
EB
EB
EB
aC
aC
aC
aC
aC
fz
fz
fz
fz
fz
mA
GF
mA
"}
